1 1 1 1 1 1 1 1 1 1 1 1 1 1 1 1 1 1 1 1 1 1 2 2 2 2 2 1 1 1 1 1 1 1 1 1 1 1 1 1 26 1 1 1 1 1 1 1 1 1 
1 1 1 1 1 1 1 1 1 1 1 1 1 1 1 1 1 1 1 1 1 1 2 2 2 2 2 1 1 1 1 1 1 26 1 25 1 1 1 1 1 1 1 1 1 1 1 1 1 1 
1 1 1 1 1 25 1 1 1 1 1 1 1 25 1 1 1 1 1 1 1 1 2 2 2 2 2 1 1 1 1 1 1 26 25 1 1 1 1 1 1 1 1 1 26 1 1 1 1 1 
1 1 1 1 1 1 1 1 1 1 1 1 1 1 1 1 1 1 1 1 1 1 2 2 2 2 2 1 1 1 1 1 1 1 1 1 1 1 1 1 1 1 1 1 1 1 1 1 1 1 
1 1 1 1 1 1 1 1 1 1 1 1 1 1 1 1 1 25 1 1 1 1 2 2 2 2 2 1 25 1 1 1 1 1 1 1 1 1 1 25 1 1 1 1 1 1 1 1 1 1 
1 1 1 1 1 1 1 1 1 1 1 1 1 1 25 1 1 1 1 1 1 1 2 2 2 2 2 1 1 1 1 1 1 1 1 1 1 1 1 1 1 1 1 1 1 1 26 1 1 1 
1 1 26 1 1 1 1 1 1 1 1 1 1 1 1 1 1 1 1 1 1 1 2 2 2 2 2 1 1 1 1 1 1 1 1 1 1 1 1 1 1 1 25 1 1 1 1 1 1 1 
1 1 1 1 1 1 1 1 1 1 1 1 1 1 1 1 1 1 1 1 1 1 2 2 2 2 2 1 1 25 1 25 1 1 1 1 25 25 1 1 1 1 1 1 1 1 1 1 1 1 
1 1 1 1 25 1 1 1 1 1 1 1 1 1 25 1 1 1 1 1 25 1 2 2 2 2 2 1 1 1 1 1 1 1 1 1 1 1 1 1 1 1 1 1 1 1 1 1 1 1 
1 1 1 1 1 1 24 24 1 1 24 24 1 1 1 1 1 1 1 1 1 1 2 2 2 2 2 1 1 1 1 1 1 1 26 1 1 1 1 1 1 1 1 25 25 1 1 1 1 1 
1 1 26 1 24 24 3 3 24 24 3 3 24 24 24 24 24 24 24 24 24 24 2 2 2 2 2 24 24 24 24 24 24 24 24 24 24 24 24 24 24 24 24 1 1 1 1 1 1 1 
1 1 1 22 3 3 3 3 3 3 3 3 3 3 3 20 3 3 3 3 3 3 90 90 90 90 90 3 3 3 3 3 3 3 3 3 3 21 3 3 3 3 3 27 1 1 1 1 1 1 
1 1 1 22 3 20 3 3 3 3 3 3 3 3 3 3 3 3 21 3 3 3 90 90 90 90 90 3 3 20 3 3 3 3 3 3 3 3 3 3 20 3 3 27 1 26 1 1 1 1 
1 1 26 1 23 23 23 23 23 23 3 3 23 23 23 23 23 23 23 23 23 23 2 2 2 2 2 23 23 23 23 23 23 23 23 23 23 23 23 23 23 23 23 1 1 1 1 1 1 1 
1 1 1 1 1 1 1 1 1 22 3 3 27 1 1 1 1 1 1 1 1 1 2 2 2 2 2 1 1 1 1 1 1 1 1 1 1 1 1 1 1 1 1 1 1 1 1 1 1 1 
1 1 1 1 1 1 1 1 1 22 3 3 27 1 1 1 1 1 1 1 1 1 2 2 2 2 2 1 1 1 1 1 1 1 1 1 1 1 1 1 1 1 1 1 1 1 1 1 1 1 
1 1 1 1 1 26 1 25 1 22 3 3 27 1 1 25 1 1 1 1 1 1 2 2 2 2 2 1 1 1 1 1 1 25 26 1 1 1 1 1 1 25 1 1 26 1 1 1 1 1 
1 24 24 24 24 24 24 24 24 22 3 3 27 24 24 24 24 1 1 1 26 1 2 2 2 2 2 1 1 1 1 1 1 1 1 1 1 1 26 1 1 1 1 1 1 1 1 1 1 1 
1 3 3 3 3 3 3 3 3 3 3 3 3 3 3 3 3 27 1 1 1 1 2 2 2 2 2 1 1 1 1 1 1 1 1 1 1 1 1 1 1 1 1 1 1 1 1 1 1 1 
1 81 83 3 81 82 83 3 81 82 82 82 83 3 81 83 3 27 1 25 1 1 2 2 2 2 2 1 1 1 1 1 1 1 26 1 1 1 1 1 1 1 1 1 25 1 1 1 1 1 
1 84 86 3 84 85 86 3 84 85 85 85 86 3 84 86 3 27 1 1 1 1 2 2 2 2 2 1 1 1 1 1 25 1 1 1 1 1 1 25 1 1 26 1 1 1 1 1 1 1 
1 84 86 3 84 85 86 3 84 85 85 85 86 3 84 86 3 27 1 1 1 1 2 2 2 2 2 1 1 25 1 1 1 1 1 1 1 1 1 1 1 1 1 1 1 1 1 1 1 1 
1 87 89 3 87 88 89 3 87 88 88 88 89 3 87 89 3 27 1 1 1 1 2 2 2 2 2 1 1 1 1 1 1 1 1 1 1 1 1 1 1 1 25 25 1 1 1 1 1 1 
1 3 3 3 3 3 3 3 3 3 3 3 3 3 3 3 3 27 1 1 1 1 2 2 2 2 2 1 1 1 1 1 1 1 1 1 1 1 1 1 1 1 1 1 1 1 1 1 1 1 
1 23 23 23 23 23 23 23 23 23 23 23 23 23 23 23 23 1 1 1 1 1 2 2 2 2 2 1 1 1 1 1 1 1 1 1 1 1 25 1 1 1 1 1 1 1 1 1 1 1
