1 1 1 1 1 1 1 1 1 1 1 1 1 1 1 1 1 1 1 1 1 1 1 1 1 1 1 1 1 1 1 1 1 1 1 1 1 1 1 1 1 1 1 1 1 1 1 1 1 1 
1 1 1 1 1 1 1 1 1 1 1 1 1 1 1 1 1 1 1 1 1 1 1 1 1 1 1 1 1 1 1 1 1 1 1 1 1 1 1 1 1 1 1 1 1 1 1 1 1 1 
1 1 9 10 10 10 10 10 10 10 10 10 10 10 10 10 10 10 10 10 10 10 10 10 10 10 10 10 8 1 1 9 10 10 10 10 10 10 10 10 10 10 10 10 10 10 10 8 1 1 
1 1 5 24 24 24 24 24 24 24 24 24 24 24 24 24 24 24 24 24 24 24 24 24 24 24 24 24 7 1 1 5 24 24 24 24 24 24 24 24 24 24 24 24 2 24 24 7 1 1 
1 1 5 25 25 25 25 25 25 25 25 25 25 25 25 25 25 25 25 25 25 25 25 25 25 25 25 25 7 1 1 5 25 25 25 25 25 25 25 25 25 25 25 25 2 25 25 7 1 1 
1 1 5 24 2 2 11 12 13 2 2 2 2 2 2 2 30 30 30 30 30 30 30 30 30 30 30 2 7 1 1 5 2 2 2 2 2 2 2 2 2 2 2 33 23 32 24 7 1 1 
1 1 5 25 2 2 14 15 16 2 2 2 2 2 2 33 37 37 37 37 37 37 37 37 37 37 37 32 7 1 1 5 2 2 2 2 2 2 2 2 2 2 2 33 23 32 25 7 1 1 
1 1 5 24 2 2 17 18 19 2 2 2 2 2 2 33 37 37 37 37 37 37 37 37 37 37 37 32 7 1 1 5 2 2 2 2 2 2 2 2 2 2 2 33 23 32 24 7 1 1 
1 1 5 25 2 2 20 21 22 2 2 2 2 2 2 33 37 37 37 37 37 37 37 37 37 37 37 32 7 1 1 5 2 2 2 2 2 2 2 2 2 2 2 33 23 32 25 7 1 1 
1 1 5 24 2 2 33 23 32 2 2 2 2 2 2 2 29 29 29 29 29 29 29 29 29 29 29 2 7 1 1 5 2 2 2 2 2 2 2 2 2 2 2 33 23 32 24 7 1 1 
1 1 5 25 2 2 33 23 36 30 30 30 30 30 30 30 30 30 30 30 30 30 30 30 30 30 30 30 7 1 1 5 30 30 30 30 30 30 30 30 30 30 30 35 23 32 25 7 1 1 
1 1 5 24 2 2 33 23 23 23 23 23 23 23 23 23 23 23 23 23 23 23 23 23 23 23 23 23 48 48 48 48 23 23 23 23 23 23 23 23 23 23 23 23 23 32 24 7 1 1 
1 1 5 25 2 2 2 29 29 29 29 29 29 29 31 23 34 29 29 29 29 29 29 31 23 34 29  48 48 48 48 5 29 31 23 34 29 29 29 29 29 29 29 29 29 2 25 7 1 1 
1 1 5 24 2 2 2 2 2 2 2 2 2 2 33 23 32 2 2 2 2 2 2 33 23 32 2 2 7 1 1 5 2 33 23 32 38 39 39 39 39 39 39 39 39 40 24 7 1 1 
1 1 5 25 2 2 2 2 2 2 2 2 2 2 33 23 32 2 2 2 2 2 2 33 23 32 2 2 7 1 1 5 2 33 23 32 41 1 1 1 1 1 1 1 1 42 25 7 1 1 
1 1 5 24 2 2 2 2 2 26 27 27 27 28 33 23 32 2 26 27 27 27 28 33 23 32 2 2 7 1 1 5 2 33 23 32 41 1 47 46 1 46 1 1 1 42 24 7 1 1 
1 1 5 25 2 2 2 2 2 26 34 29 31 28 35 23 32 2 26 2 2 2 28 35 23 32 2 2 7 1 1 5 2 33 23 32 41 1 1 1 1 1 1 1 1 42 25 7 1 1 
1 1 5 24 2 2 2 2 2 26 32 2 2 2 23 23 32 2 26 2 2 2 2 23 23 32 2 2 7 1 1 5 2 33 23 36 41 1 1 1 1 1 47 46 1 42 24 7 1 1 
1 1 5 25 2 2 2 2 2 26 32 2 2 28 29 29 2 2 26 2 2 2 28 29 29 2 2 2 7 1 1 5 2 33 23 23 23 1 1 1 1 1 1 1 1 42 25 7 1 1 
1 1 5 24 2 2 2 2 2 26 36 30 35 28 2 2 2 2 26 2 2 2 28 2 2 2 2 2 7 1 1 5 2 2 29 29 41 1 1 1 1 46 1 1 1 42 24 7 1 1 
1 1 5 25 2 2 2 2 2 26 27 27 27 28 2 2 2 2 26 27 27 27 28 2 2 2 2 2 7 1 1 5 2 2 2 2 41 1 47 46 1 1 47 46 1 42 25 7 1 1 
1 1 5 2 2 2 2 2 2 2 2 2 2 2 2 2 2 2 2 2 2 2 2 2 2 2 2 2 7 1 1 5 2 2 2 2 43 44 44 44 44 44 44 44 44 45 2 7 1 1 
1 1 4 3 3 3 3 3 3 3 3 3 3 3 3 3 3 3 3 3 3 3 3 3 3 3 3 3 6 1 1 4 3 3 3 3 3 3 3 3 3 3 3 3 3 3 3 6 1 1 
1 1 1 1 1 1 1 1 1 1 1 1 1 1 1 1 1 1 1 1 1 1 1 1 1 1 1 1 1 1 1 1 1 1 1 1 1 1 1 1 1 1 1 1 1 1 1 1 1 1 
1 1 1 1 1 1 1 1 1 1 1 1 1 1 1 1 1 1 1 1 1 1 1 1 1 1 1 1 1 1 1 1 1 1 1 1 1 1 1 1 1 1 1 1 1 1 1 1 1 1
